1111111111111
10P1C0E000001
1111111111111