111111
1P0001
1EC001
100001
111111