1111111111111
10010000000C1
10P0011111001
10C011E0C0001
1000E00000
1000000000001
10000110C0001
1110000000111
1111111111111
