1111111111111
10P000E0000C1
10000000000C1
10000000000C1
10000000000C1
1111111111111